xxxxxxxxxxxxxxxx
x--------------x
x--------------x
x--------------x
x--------------x 
x--------------x 
x--------------x
x^------------^x
x--------------x
x--------------x
x--------------x
x--------------x
x--------------x
x--------------x
x------^-------x
x--------------x
x--------------x
x-------^------x 
x--------------x
x--------------x
x--------------x 
x--------------xxxxxxxxxxxxxxxxxxxx
x---------------------------------x
x^------------^-------------------x
x--------------------------------gx
x---------------------------------x
x--------------xxxxxxxxxxxxxxxxxxxx
x--------------x
x--------------x
x------------g-x
x------^-------x
xxxxxxxxxxxxxxxx
|
xxxxxxxxxxxxxxxx
x------p-------x 
x--------------x
x--------------x
x--------------x 
x--------------x 
x--------------x
x--------------x
x--------------x
x--------------x
x--------------x
x--------------x
x--------------x
x--------------x
x--------------x
x--------------x
x--------------x
x--------------x 
x--------------x
x--------------x
xxxxxxxxxxxxxxxx 
x--------------xxxxxxxxxxxxxxxxxxxx
x---------------------------------x
x^------------^-------------------x
x---------------------------------x
x---------------------------------x
x--------------xxxxxxxxxxxxxxxxxxxx
x--------------x
x--------------x
x--------------x
x--------------x
xxxxxxxxxxxxxxxx
|
xxxxxxxxxxxxxxxx
xiiiiiiiiiiiiiix
xiiiiiiiiiiiiiix
xiiiiii*iiiiiiix
x--------------x
x--------------x
x--------------x
x--------------x
xiiiiiiiiiiiiiix
xiiiiiiiiiiiiiix
x--------------x
x--------------x
x--------------x
x--------------x
x--------------x
x--------------x
xiiiiiiiiiiiiiix
xiiiiiiiiiiiiiix
xiiiiiiiiiiiiiix
xiiiiii*iiiiiiix
xxxxxxxxxxxxxxxx
xiiiiiiiiiiiiiixxxxxxxxxxxxxxxxxxxx
xiiiiiiiiiiiiiiiiiiiiiiiiiiiiiiiiix
xiiiiiiiiiiiiiiiiiiiiiiiiiiiiiiiiix
xiiiiiiiiiiiiiiiiiiiiiiiiiiiiiiiiix
xiiiiiiiiiiiiiiiiiiiiiiiiiiiiiiiiix
xiiiiiiiiiiiiiixxxxxxxxxxxxxxxxxxxx
xiiiiii*iiiiiiix
xiiiiiiiiiiiiiix
xiiiiiiiiiiiiiix
xiiiiiiiiiiiiiix
xxxxxxxxxxxxxxxx